15 15
#_____#########
#______########
#___________###
#___________###
_______________
_______________
_____#_________
________##_____
________#______
#_______#_____#
_______##_____#
_______##_____#
______###_____#
_____##########
_____##########
