100 100
??????????????????????#?????????????????????????????????????????????????????????????????????????????
??????????????????????????????????????????????????????????????????????????#?????????????????????????
???#????????????????????????????????????????????????????????????????????#???????????????????????????
??#????????????????????????????????#?????????????????#??????????????????????????????????????????????
??????????????????????????????????????#?????????????????????????????????????????????????????????????
???????????????????????????????????????????????????????????????????????????????????????????#????????
??????????????????????????????????????????????????????????????????#?????????#???????????????????????
?????????#???????????????????????????????????????????????????????????????????????????????????#??????
?????????????????????????????????????????????????#????????????????????????????????#?????????????????
???????????????????????????????????????#???????#???????????????????????????????????????????????#????
?????????????????????????????????????????????????????????????????????????????????#??????????????????
???????????????________________?_________________________________????????????????#??????????????????
???????????????__________________________________________________???????????????????????????????????
???????????????______________________________________________?________________________??#???????#???
???????????????_______________________________________________________________________???????#??????
??????????#????____________________________?__________________________________________??????????????
????????????______________________________________________?__?______________?_________??????????????
????????????___________________________________?______________________________________??????????????
?#??????????_________________________________?_?______________________________________??????????????
???????#????________________________?_________________________________________________??????????????
????????????__________________?____________________?__?_______________________________??????????????
______________________________________________________________________________________??#???????????
_____________________________________?________________________________________________??????????????
_______?________________?_________________________________?__________________________???????????????
___________?____________________________________________________________?_____________??????????????
________________________________________?_____________________________________________??????????????
_______________?_________________________________________________________?____________??????????????
___?_____?______________?_____________________________________________________?_______??????????????
___________________________?______________________________________?___________________???????????#??
_____?___?_____________________________________________??_____________________________??????????????
_______________________________________________________?_?_____________________?______??????????????
________________________?________?_____________________________________________?______??????????????
________________________________________________________?_____________________________??????????????
__________________________________________________?___________________________________??????????????
___?____________________________________________________________?_____________________??????????????
___________________________________________________________________________?__________??????????????
____________________?_____?___________________________________________________________??????????????
_____?____?_____?____________________________?____?___________________________________??????????????
_____________________________________________________________________________________?__????????????
________________________________________________________________________________________????????????
_____________________________________________________?__________________________________????????????
____________________________________________________________________________________?___????????????
______________________?____________________?__________________________________?_________????????????
________________________________________?_____?_________________________________________????#???????
__________________?______________________?______________________________________?_______????????????
____________________________________?_____________________?___?_________________________????????????
_____________________________________________________?_________________________________?????????????
__________________________________________________?_____________________________________????????????
____________________________________________________?___________________________________????????????
___?____________________________________________________________________________________#???????????
__?_____________________________________________________________________________________????????????
___________________?______________________________________?_____________________________????????????
________________________________________________________________________________________????????????
_____________?_________??_______________________________________________________________????????????
_____________________________________________?________________________________?________?????????????
__________________________________________________?_____________________?_______________??#???????#?
____________?_______?_________??________________________________________________________????????????
_?_______________________________________________________?________________?_____________????????????
______________________________________?_________________________________________________??????????#?
__________________?______________?______________________________________________________????????????
____________________________________________?______?__________?_________________________#???????????
______?_________________________________________?_________________?___________?_________????????????
_______________________?______________________________?_________________________________????????????
___________________________________?__________?_______________________________________?_????????????
___________________?__________________________________________________________________?_????????????
_________________________________________?______?_______?____________________________?__????????????
_?_____________________________________________________?______________________________?_????????????
________________________________________________________________________________________????????????
______________________?______________________?_____________?____________________________????????????
____________?___________________________________________________________________________????????????
________________________________________________________________________________________?????#??????
??????????____________________?____________________________________?__________?_________????????????
??????????___________________________?__________________________________________________?#??????????
??????????_______________?____?_________________________________________________________????????????
????#??????___________________________________?___________________________________?_____????????????
??????#?#?___?______?_______________?_________?_________________________________________????????????
??????????______________________________________________________________________________??????????#?
??????????_______________________________?______________________________________________????????????
??????????_______________________________________________________?______________________??#?????????
??????????_________________?_________________________________?__________________________????????????
??????????___________________?__________________________________________________________??#?????????
??????????________________?_________________________________?___________________________????????????
??????????___________?_____________________?____________________________________________????????????
??????????______________________________________________________________________________????????????
#?????????______________________________________________________________________________????????????
??????????____________________________________?_________________________________________????????????
??????????______________________________________________________________________________????????????
??????????_________________________________________________?____________________________????????????
?????#????_________??______?____________________________________________________________????????????
#?????????______________________________________________________________________________????????????
??????????______________________________________________________________________________????????????
??????????_______?______________________________________________________________________????????????
??????????_________________________________________?____________________________________????????????
??????????______?_______________________________________________________________________????????????
??????????___________________?______________?___________________________________________??#?????????
?????#????______________________________________________________________________________????????????
??????????__________?_________________________________________________?_________________????????????
????#?????#???????????#???????????????__?_____________________________________________?_????????????
???????????????????????????????????????_________________________________________________????????????
??????????????????????????????????????_______________________??_________________________????????????
